1111111111111111
1000010190000001
1011010111100101
1001300004110111
1011011101110001
1001017001010101
1001011101000101
1001110004100101
1310100004100131
1011011101110101
1810000000023001
1111111111111111
